{
	"name":"Inside Maya Temple",
	"spawnX":29,
	"spawnY":34,
	"background":"mayan.png",
	"tiles":[
		[10,10,10,10,10,10,10,10,10,10,10,10,10,10,10,10,10,10,10,10,10,10,10,10,10,10,10,10,10,10,10,10,10,10,1],
		[10,10,10,10,10,10,10,10,10,10,10,10,10,10,10,10,10,10,10,10,10,10,10,10,10,10,10,10,10,10,10,10,10,10,10],
		[10,10,10,10,10,10,10,10,10,10,10,10,10,10,10,10,10,10,10,10,10,10,10,10,0,0,0,0,0,0,10,10,10,10,10],
		[10,10,10,10,10,10,10,10,10,10,10,10,10,10,10,10,10,10,10,10,10,10,10,0,0,0,0,0,0,0,0,10,10,10,10],
		[10,10,10,10,24,24,24,24,24,10,10,10,10,10,10,10,10,10,10,10,10,10,0,0,0,0,0,0,0,0,0,0,10,10,10],
		[10,10,24,24,0,0,0,0,0,24,24,24,10,10,10,10,10,10,10,10,10,0,0,0,0,0,0,0,0,0,0,0,0,10,10],
		[24,24,0,0,0,0,0,0,0,0,0,0,24,24,10,10,10,10,10,10,0,0,0,0,0,10,0,0,0,0,0,0,0,10,10],
		[0,0,0,0,0,0,0,0,0,0,0,0,0,0,24,24,24,24,10,0,0,0,0,0,10,21,0,0,0,0,0,0,0,10,10],
		[0,0,0,0,0,0,0,0,0,0,0,0,0,0,0,0,0,0,0,0,0,0,0,10,10,21,0,0,0,0,0,0,0,10,10],
		[0,0,0,0,0,0,0,0,0,0,0,0,0,0,0,0,0,0,0,0,0,0,10,10,10,21,0,0,0,0,0,0,0,10,10],
		[0,0,0,0,22,22,22,22,22,0,0,0,0,0,0,0,0,0,0,0,0,10,10,10,10,21,0,0,0,0,0,0,0,10,10],
		[0,0,22,22,10,10,10,10,10,22,22,22,0,0,0,0,0,0,0,0,10,10,10,10,10,21,0,0,0,0,0,0,0,10,10],
		[22,22,10,10,10,10,10,10,10,10,10,10,22,22,0,0,0,0,0,10,10,10,10,10,10,21,0,0,0,0,0,0,0,10,10],
		[10,10,10,10,10,10,10,10,10,10,10,10,10,10,22,22,22,22,10,10,10,10,10,10,10,21,0,0,0,0,0,0,0,10,10],
		[10,10,10,10,10,10,10,10,10,10,10,10,10,10,10,10,10,10,10,10,10,10,10,10,10,21,0,0,0,0,0,0,0,10,10],
		[10,10,10,10,10,10,10,10,10,10,10,10,10,10,10,10,10,10,10,10,10,10,10,10,10,21,0,0,0,0,0,0,0,10,10],
		[10,10,10,10,10,10,10,10,10,10,10,10,10,10,10,10,10,10,10,10,10,10,10,10,10,21,0,0,0,0,0,0,0,10,10],
		[10,10,0,0,0,0,0,0,0,0,0,10,0,0,0,10,10,10,10,10,10,10,10,10,10,21,0,0,0,0,0,0,0,10,10],
		[10,10,0,0,0,0,0,0,0,0,0,10,0,0,0,10,10,10,10,10,10,10,10,10,10,21,0,0,0,0,0,0,0,10,10],
		[10,10,0,0,0,0,0,0,0,0,0,10,0,0,0,10,10,10,10,10,10,10,10,10,10,10,0,0,0,0,0,0,0,10,10],
		[10,10,0,0,0,10,0,0,0,0,0,10,0,0,0,10,10,10,10,0,0,0,0,10,10,10,0,0,0,0,0,0,0,10,10],
		[10,10,0,0,0,10,0,0,0,0,0,0,0,0,0,10,10,10,0,0,0,0,0,0,10,10,0,0,0,0,0,0,0,10,10],
		[10,10,0,0,0,10,0,0,0,0,0,0,0,0,0,10,10,10,0,0,0,0,0,0,10,10,0,0,0,0,0,0,0,10,10],
		[10,10,0,0,0,10,0,0,0,0,0,0,0,0,0,10,10,0,0,0,0,0,0,0,10,10,0,0,0,0,0,0,0,10,10],
		[10,10,5,30,5,10,10,10,10,10,10,10,10,10,10,10,10,0,0,0,0,0,0,0,10,10,0,0,0,0,0,0,0,10,10],
		[10,10,0,0,0,10,10,10,10,10,10,10,10,10,10,10,0,0,0,0,0,0,0,0,10,10,0,0,0,0,0,0,0,10,10],
		[10,10,0,0,0,0,0,0,0,0,10,10,10,10,10,10,0,0,0,0,0,0,0,0,10,10,0,0,0,0,0,0,0,10,10],
		[10,10,0,0,0,0,0,0,0,0,10,10,10,10,10,0,0,0,0,0,0,0,0,0,10,10,0,0,0,0,0,0,0,0,10],
		[10,10,0,0,0,0,0,0,0,0,10,10,10,10,10,0,0,0,0,0,0,0,0,0,10,10,0,0,0,0,0,0,0,0,0],
		[0,0,0,0,0,0,0,0,0,0,10,10,10,10,0,0,0,0,0,0,0,0,0,0,10,10,0,0,0,0,0,0,0,0,0],
		[0,0,0,0,0,0,0,0,0,0,10,10,10,10,0,0,0,0,0,0,0,0,0,0,10,10,0,0,0,0,0,0,0,0,0],
		[0,0,0,0,0,0,0,0,0,0,10,10,10,0,0,0,0,0,0,0,0,0,0,0,10,10,0,0,0,0,0,0,0,0,0],
		[0,0,0,0,0,0,0,0,0,0,10,10,10,0,0,0,0,0,0,0,0,0,0,0,10,10,0,0,0,0,0,0,0,0,10],
		[10,10,0,0,0,0,0,0,0,0,10,10,0,0,0,0,0,0,0,0,0,0,0,0,10,10,0,0,0,0,0,0,0,10,10],
		[10,10,0,0,0,0,0,0,0,0,10,10,0,0,0,0,0,0,0,0,0,0,0,0,10,10,0,0,0,0,0,0,0,10,10],
		[0,0,0,0,0,0,0,0,0,0,10,10,0,0,0,0,0,0,0,0,0,0,0,0,10,10,0,0,0,0,0,0,0,10,10],
		[0,0,0,0,0,0,0,0,0,0,10,10,0,0,0,0,0,0,0,0,0,0,0,0,10,10,0,0,0,0,0,0,0,10,10],
		[0,0,0,0,0,0,0,0,0,0,10,10,0,0,0,0,0,0,0,0,0,0,0,0,10,10,0,0,0,0,0,0,0,10,10],
		[0,0,0,0,0,0,0,0,0,0,10,10,0,0,0,0,0,0,0,0,0,0,0,0,10,10,0,0,0,0,0,0,0,10,10],
		[10,10,0,0,0,0,0,0,0,0,10,10,0,0,0,0,0,0,0,0,0,0,0,0,10,10,0,0,0,0,0,0,0,10,10],
		[10,10,0,0,0,0,0,0,0,0,10,10,0,0,0,0,0,0,0,0,0,0,0,0,10,10,0,0,0,0,0,0,0,10,10],
		[0,0,0,0,0,0,0,0,0,0,10,10,0,0,0,0,0,0,0,0,0,0,0,0,10,28,0,0,0,0,0,0,0,10,10],
		[0,0,0,0,0,0,0,0,0,0,10,10,0,0,0,0,0,0,0,0,0,0,0,0,10,28,0,0,0,0,0,0,0,10,10],
		[0,0,0,0,0,0,0,0,0,0,10,10,0,0,0,0,0,0,0,0,0,0,0,0,10,28,0,9,9,9,0,10,0,10,10],
		[0,0,0,0,0,0,0,0,0,0,10,10,0,0,0,0,0,0,0,0,0,0,0,0,10,28,0,9,11,9,10,0,10,0,10],
		[10,10,0,0,0,0,0,0,0,0,10,10,0,0,0,0,0,0,0,0,0,0,0,0,10,28,0,9,9,9,0,10,0,10,10],
		[10,10,0,0,0,0,0,0,0,0,10,10,0,0,0,0,0,0,0,0,0,0,0,0,10,28,0,0,0,0,0,0,0,10,10],
		[10,10,0,0,0,0,0,0,0,0,10,10,0,0,0,0,0,0,0,0,0,0,10,10,10,28,0,0,0,0,0,0,0,10,10],
		[10,10,0,0,0,0,0,0,0,0,10,10,0,0,0,0,0,0,0,0,0,10,10,10,10,0,0,0,0,0,0,0,0,10,10],
		[10,10,0,0,0,0,0,0,0,0,10,10,0,0,0,0,0,0,0,0,0,10,10,21,0,0,0,0,0,0,0,0,0,10,10],
		[10,10,0,0,0,0,0,0,0,0,10,10,0,0,0,0,0,0,0,0,0,10,10,21,0,0,0,0,0,0,0,0,0,10,10],
		[10,10,0,0,0,0,0,0,0,0,10,10,0,0,0,0,0,0,0,0,0,10,10,21,0,0,0,0,0,0,0,0,0,10,10],
		[10,10,0,0,0,0,0,0,0,0,10,10,0,0,0,0,0,0,0,0,0,10,10,21,0,0,0,0,0,0,0,0,0,10,10],
		[10,10,0,0,0,0,0,0,0,0,10,10,0,0,0,0,0,0,0,0,0,10,10,21,0,0,0,0,0,0,0,0,0,10,10],
		[10,10,0,0,0,0,0,0,0,0,10,10,0,0,0,0,0,0,0,0,0,10,10,10,10,0,0,0,0,0,0,0,0,10,10],
		[10,10,10,0,0,0,10,10,10,10,10,10,0,0,0,10,10,10,10,10,10,10,10,10,10,10,0,0,0,0,0,0,0,10,10],
		[20,0,0,0,0,0,0,0,0,0,0,0,0,0,0,0,0,0,0,0,0,0,0,0,0,0,0,0,0,0,0,0,0,10,10],
		[20,0,0,0,0,0,0,0,0,0,0,0,0,0,0,0,0,0,0,0,0,0,0,0,0,0,0,0,0,0,0,0,0,10,10],
		[10,10,10,10,10,10,10,10,10,10,10,10,10,10,10,10,10,10,10,10,10,10,10,10,10,10,10,10,10,10,10,10,10,10,10],
		[10,10,10,10,10,10,10,10,10,10,10,10,10,10,10,10,10,10,10,10,10,10,10,10,10,10,10,10,10,10,10,10,10,10,10]
	],
	"topBorder": "true",
	"buttomBorder": "true",
	"leftBorder": "true",
	"rightBorder": "true",
	"links": [
		{
			"target": {
				"name": "test-map3",
				"x": 13,
				"y": 16
			},
			"type": "down",
			"min": 0,
			"max": 30
		},
		{
			"target": {
				"name": "test-map3",
				"x": 48,
				"y": 16
			},
			"type": "down",
			"min": 31,
			"max": 60
		}
	]
}