{
	"name":"TestMap",
	"spawnX":2,
	"spawnY":4,
	"background":"hills.png",
	"tiles":[
		[1,1,1,2,0,0,0,0,0,0,0,0,0,0,0],
		[1,1,3,2,0,0,0,0,0,0,0,0,0,0,0],
		[1,1,3,2,0,0,0,0,0,0,0,0,0,0,0],
		[1,3,2,0,0,0,0,0,0,0,0,0,0,0,0],
		[3,2,-18,0,0,0,0,0,0,0,0,0,0,0,0],
		[2,0,0,0,0,0,0,0,0,0,0,0,0,0,0],
		[0,0,0,0,0,0,0,0,0,0,0,0,0,0,0],
		[0,0,0,0,0,3,2,0,0,0,0,0,0,0,0],
		[0,0,0,0,0,1,2,0,0,0,0,0,0,0,0],
		[-18,0,0,0,3,1,1,2,0,0,0,0,0,0,0],
		[0,0,0,0,3,1,1,2,-18,0,0,0,0,0,0],
		[0,0,0,0,0,3,2,0,0,0,0,0,0,0,0],
		[0,0,0,0,0,0,2,0,0,0,0,0,0,0,0],
		[0,0,0,0,0,0,0,0,0,0,0,0,0,0,0],
		[2,0,0,0,0,0,0,0,0,0,0,0,0,0,0],
		[3,2,0,0,0,0,0,0,0,0,0,0,0,0,0],
		[1,3,2,0,0,0,0,0,0,0,0,0,0,0,0],
		[1,1,3,2,0,0,0,0,0,0,0,0,0,0,0],
		[1,1,3,2,0,0,0,0,0,0,0,0,0,0,0],
		[1,3,2,0,0,0,0,0,0,0,0,0,0,0,0],
		[1,3,2,0,0,0,0,0,0,0,0,0,0,0,0],
		[1,3,2,0,0,0,0,0,0,0,0,0,0,0,0],
		[1,1,3,2,0,0,0,0,0,0,0,0,0,0,0],
		[1,1,1,3,2,-18,0,0,0,0,0,0,0,0,0],
		[1,1,1,3,2,0,0,0,0,0,0,0,0,0,0],
		[1,1,3,2,0,0,0,0,0,0,0,0,0,0,0],
		[1,3,2,0,0,0,0,0,0,0,0,0,0,0,0],
		[3,2,0,0,0,0,0,0,0,0,0,0,0,0,0]
	],
	"leftBorder": "false",
	"links": [
		{
			"target": {
				"name": "test-map3",
				"x": 59,
				"y": 12
			},
			"type": "left",
			"min": 0,
			"max": 15
		}
	]
}