{
	"name":"TestMap2",
	"spawnX":18,
	"spawnY":1,
	"background":"hills.png",
	"tiles":[
		[ 1, 0, 0, 0, 0, 0, 3, 0, 0, 0, 0, 0, 0, 2,2],
		[ 1, 0, 0, 2, 0, 0, 3, 0, 0, 3, 3, 0, 0, 2, 2],
		[ 1, 0, 0, 2, 0, 0, 0, 0, 0, 3, 3, 0, 0, 2, 0],
		[ 1, 0, 0, 2, 0, 0, 0, 0, 0, 3, 2, 0, 0, 0, 0],
		[ 1, 0, 0, 0, 2, 3, 3, 3, 3, 2, 2, 0, 0, 0, 0],
		[ 1, 0, 0, 0, 0, 2, 3, 3, 2, 2, 3, 2, 0, 0, 0],
		[ 1, 0, 0, 0, 0, 2, 2, 2, 2, 0, 0, 0, 0, 0, 0],
		[ 1, 0, 0, 0, 0, 0, 2, 2, 0, 0, 0, 0, 0, 0, 0],
		[ 1, 1, 0, 0, 0, 0, 2, 2, 0, 0, 0, 0, 0, 0, 0],
		[ 0, 1, 0, 0, 0, 0, 0, 0, 0, 0, 0, 0, 0, 0, 0],
		[ 0, 0, 1, 0, 0, 0, 0, 0, 0, 0, 0, 0, 0, 0, 0],
		[ 0, 0, 0, 1, 0, 0, 0, 0, 0, 0, 0, 0, 0, 0, 0],
		[ 0, 0, 0, 0, 1, 0, 0, 0, 0, 0, 0, 0, 0, 0, 0],
		[ 0, 0, 0, 0, 1, 0, 0, 0, 0, 0, 0, 0, 0, 0, 0],
		[ 0, 0, 0, 0, 0, 1, 0, 0, 0, 0, 1, 1, 0, 0, 0],
		[ 0, 0, 0, 0, 0, 1, 0, 0, 0, 0, 1, 1, 1, 0, 0],
		[ 0, 0, 0, 0, 0, 1, 0, 0, 0, 1, 1, 1, 1, 0, 0],
		[ 1, 0, 0, 0, 0, 1, 0, 0, 0, 1, 1, 1, 1, 0, 0],
		[ 1, 0, 0, 0, 0, 1, 0, 0, 0, 1, 1, 1, 1, 0, 0],
		[ 1, 0, 0, 0, 0, 1, 0, 0, 0, 1, 1, 1, 0, 0, 0],
		[ 1, 0, 0, 0, 0, 1, 0, 0, 0, 1, 1, 0, 0, 0, 1],
		[ 1, 0, 0, 0, 0, 1, 0, 0, 0, 1, 1, 0, 0, 0, 1],
		[ 1, 0, 0, 0, 0, 1, 0, 0, 0, 0, 0, 0, 0, 1, 1],
		[ 1, 0, 0, 0, 0, 1, 0, 0, 0, 0, 0, 0, 0, 1, 1],
		[ 1, 0, 0, 0, 0, 0, 0, 0, 0, 0, 0, 0, 1, 1, 1],
		[ 1, 0, 0, 0, 0, 0, 0, 0, 0, 0, 0, 1, 1, 1, 1],
		[ 1, 0, 0, 0, 0, 0, 0, 0, 0, 1, 1, 1, 1, 1, 1],
		[ 1, 0, 0, 0, 0, 0, 0, 0, 0, 1, 1, 1, 1, 1, 1],
		[ 1, 1, 0, 0, 0, 0, 1, 1, 1, 1, 1, 1, 1, 1, 1],
		[ 1, 1, 1, 1, 1, 1, 1, 1, 1, 1, 1, 1, 1, 1, 1]
	],
	"topBorder": "false",
	"buttomBorder": "false",
	"links": [
		{
			"target": {
				"name": "test-map3",
				"x": 24,
				"y": 0
			},
			"type": "up",
			"min": 0,
			"max": 14
		},
		{
			"target": {
				"name": "test-map3",
				"x": 40,
				"y": 0
			},
			"type": "up",
			"min": 15,
			"max": 30
		},
		{
			"target": {
				"name": "test5",
				"x": 21,
				"y": 14
			},
			"type": "down",
			"min": 0,
			"max": 30
		}
	]
}