{
	"name":"TestMap 3",
	"spawnX":5,
	"spawnY":4,
	"background":"hills.png",
	"tiles":[
		[ 1, 1, 1, 1, 1, 1, 1, 1, 1, 3, 3, 3, 3, 2,0],
		[ 1, 1, 1, 3, 3, 3, 3, 1, 2, 0, 0, 0, 3, 3, 2],
		[ 1, 1, 3, 2, 0, 0, 0, 3, 2, 0, 0, 0, 0, 3, 2],
		[ 1, 1, 2, 0, 0, 0, 0, 0, 2, 0, 0, 0, 0, 3, 2],
		[ 1, 3, 2, 0, 0, 0, 0, 0, 0, 0, 0, 0, 3, 2, -11],
		[ 1, 3, 2, 0, 0, 0, 0, 0, 0, 0, 0, 0, 0, 0, 0],
		[ 1, 1, 3, 2, -11, 0, 0, 0, 0, 0, 0, 0, 0, 0, 0],
		[ 1, 1, 3, 2, 0, 0, 0, 0, 0, 0, 0, 0, 0, 0, 0],
		[ 1, 1, 3, 2, 0, 0, 0, 0, 0, 0, 0, 0, 0, 0, 0],
		[ 1, 1, 2, 0, 0, 0, 0, 0, 0, 0, 0, 0, 0, 0, 0],
		[ 1, 3, 2, 0, 0, 0, 0, 0, 0, 0, 0, 0, 0, 0, 0],
		[ 2, 2, 0, 0, 0, 0, 0, 0, 0, 0, 0, 0, 0, 0, 0],
		[ 2, 0, 0, 0, 0, 0, 0, 0, 0, 0, 0, 0, 0, 0, 0],
		[ 2, -11, 0, 0, 0, 0, 0, 0, 0, 0, 0, 0, 0, 0, 0],
		[ 2, 0, 0, 0, 0, 0, 0, 0, 0, 0, 0, 0, 0, 0, 0],
		[ 2, 0, 0, 0, 0, 0, 0, 0, 0, 0, 0, 0, 0, 0, 0],
		[ 3, 2, 0, 0, 0, 0, 0, 0, 0, 0, 0, 0, 0, 0, 0],
		[ 3, 2, 0, 0, 0, 0, 0, 0, 0, 0, 0, 0, 0, 0, 0],
		[ 3, 1, 0, 0, 0, 0, 0, 0, 0, 0, 0, 0, 0, 0, 0],
		[ 1, 0, 0, 0, 0, 1, 2, 0, 0, 0, 0, 0, 0, 0, 0],
		[ 1, 0, 0, 0, 0, 1, 3, 3, 2, -11, 0, 0, 0, 0, 0],
		[ 1, 0, 0, 0, 0, 0, 1, 3, 2, 0, 0, 0, 0, 0, 0],
		[ 1, 0, 0, 0, 0, 0, 1, 3, 3, 2, 0, 0, 0, 0, 0],
		[ 1, 0, 0, 0, 0, 1, 1, 3, 3, 2, -11, 0, 0, 0, 0],
		[ 1, 0, 0, 0, 1, 1, 3, 3, 2, 0, 0, 0, 0, 0, 0],
		[ 1, 0, 0, 0, 1, 3, 3, 2, 0, 0, 0, 0, 0, 0, 0],
		[ 1, 0, 0, 0, 1, 3, 2, 0, 0, 0, 0, 0, 0, 0, 0],
		[ 1, 0, 0, 0, 0, 0, 0, 0, 0, 0, 0, 0, 0, 0, 0],
		[ 2, 0, 0, 0, 0, 0, 0, 0, 0, 0, 0, 0, 0, 0, 0],
		[ 2, 0, 0, 0, 0, 0, 0, 0, 0, 0, 0, 0, 0, 0, 0],
		[ 2, 0, 0, 0, 0, 0, 0, 0, 0, 0, 0, 0, 0, 0, 0],
		[ 1, 2, 0, 0, 0, 0, 0, 0, 0, 0, 0, 0, 0, 0, 0],
		[ 1, 1, 3, 2, 0, 0, 0, 0, 0, 0, 0, 0, 0, 0, 0],
		[ 3, 1, 1, 3, 2, 0, 0, 0, 0, 0, 0, 0, 0, 0, 0],
		[ 1, 2, 0, 0, 3, 3, 1, 2, 0, 0, 0, 0, 0, 0, 0],
		[ 3, 2, 0, 0, 0, 0, 0, 1, 3, 2, 0, 0, 0, 0, 0],
		[ 2, 0, 0, 0, 0, 0, 0, 0, 0, 3, 2, -11, 0, 0, 0],
		[ 2, 0, 0, 0, 0, 0, 0, 0, 0, 0, 0, 0, 0, 0, 0],
		[ 2, 0, 0, 0, 2, 0, 0, 0, 0, 0, 0, 0, 0, 0, 0],
		[ 2, 0, 0, 0, 3, 2, 0, 0, 0, 0, 0, 0, 0, 0, 0],
		[ 2, 0, 0, 0, 0, 3, 2, 0, 0, 0, 0, 0, 0, 0, 0],
		[ 2, 0, 0, 0, 0, 3, 3, 3, 3, 3, 2, 0, 0, 0, 0],
		[ 2, 0, 0, 0, 3, 1, 1, 2, 0, 0, 0, 0, 0, 0, 0],
		[ 1, 2, -11, 3, 2, 0, 0, 0, 0, 0, 0, 0, 0, 0, 0],
		[ 1, 1, 3, 2, -11, 0, 0, 0, 0, 0, 0, 0, 0, 0, 0],
		[ 1, 2, 0, 0, 0, 0, 0, 0, 0, 0, 0, 0, 0, 0, 0],
		[ 2, 0, 0, 0, 0, 0, 0, 0, 0, 0, 0, 0, 0, 0, 0],
		[ 2, 0, 0, 0, 0, 0, 0, 0, 0, 0, 0, 0, 0, 0, 0],
		[ 2, 0, 0, 0, 0, 0, 0, 0, 0, 0, 0, 0, 0, 0, 0],
		[ 2, 0, 0, 0, 0, 0, 0, 0, 0, 0, 0, 0, 0, 0, 0],
		[ 2, 0, 0, 0, 0, 0, 0, 0, 2, 0, 0, 0, 0, 0, 0],
		[ 2, 0, 0, 0, 0, 0, 0, 0, 3, 2, 0, 0, 0, 0, 0],
		[ 3, 2, 0, 0, 0, 0, 0, 0, 0, 3, 2, 0, 0, 0, 0],
		[ 3, 3, 2, 0, 0, 0, 0, 0, 0, 3, 3, 2, 0, 0, 0],
		[ 1, 3, 2, 0, 0, 0, 0, 0, 0, 0, 3, 2, 0, 0, 0],
		[ 1, 3, 3, 2, -11, 0, 0, 0, 0, 0, 3, 2, -11, 0, 0],
		[ 1, 1, 3, 3, 2, 0, 0, 0, 0, 0, 3, 2, 0, 0, 0],
		[ 1, 1, 1, 1, 3, 3, 2, 0, 3, 3, 3, 1, 2, 0, 0],
		[ 1, 1, 1, 1, 1, 3, 3, 3, 1, 1, 1, 1, 3, 3, 2],
		[ 1, 1, 1, 1, 1, 1, 1, 1, 1, 1, 1, 1, 1, 3, 2]
	]
}