{
	"name":"TestMap 3",
	"spawnX":2,
	"spawnY":9,
	"background":"hills.png",
	"tiles":[
		[ 1, 1, 1, 1, 1, 1, 1, 1, 1, 3, 3, 3, 3, 2,0],
		[ 1, 1, 1, 3, 3, 3, 3, 1, 2, 0, 0, 0, 3, 3, 2],
		[ 1, 1, 3, 2, 0, 0, 0, 3, 2, 0, 0, 0, 0, 3, 2],
		[ 1, 1, 2, 0, 0, 0, 0, 0, 2, 0, 0, 0, 0, 3, 2],
		[ 1, 3, 2, 0, 0, 0, 0, 0, 0, 0, 0, 0, 3, 2, -18],
		[ 1, 3, 2, 0, 0, 0, 0, 0, 0, 0, 0, 0, 0, 0, 0],
		[ 1, 1, 3, 2, -18, 0, 0, 0, 0, 0, 0, 0, 0, 0, 0],
		[ 1, 1, 3, 3, 2, 0, 0, 0, 0, 0, 0, 0, 0, 0, 0],
		[ 1, 1, 3, 3, 2, 0, 0, 0, 0, 0, 0, 0, 0, 0, 0],
		[ 1, 1, 3, 2, 0, 0, 0, 0, 0, 0, 0, 0, 0, 0, 0],
		[ 1, 3, 2, 0, 0, 0, 0, 0, 0, 0, 0, 0, 0, 0, 0],
		[ 3, 2, 0, 0, 0, 0, 0, 0, 0, 0, 0, 0, 0, 0, 0],
		[ 2, 0, 0, 0, 0, 0, 0, 0, 0, 0, 0, 0, 0, 0, 0],
		[ 2, -18, 0, 0, 0, 0, 0, 0, 0, 0, 0, 0, 0, 0, 0],
		[ 2, 0, 0, 0, 0, 0, 0, 0, 0, 0, 0, 0, 0, 0, 0],
		[ 2, 0, 0, 0, 0, 0, 0, 0, 0, 0, 0, 0, 0, 0, 0],
		[ 3, 2, 0, 0, 0, 0, 0, 0, 0, 0, 0, 0, 0, 0, 0],
		[ 3, 2, 0, 0, 0, 0, 0, 0, 0, 0, 0, 0, 0, 0, 0],
		[ 3, 1, 0, 0, 0, 0, 0, 0, 0, 0, 0, 0, 0, 0, 0],
		[ 1, 0, 0, 0, 0, 1, 2, 0, 0, 0, 0, 0, 0, 0, 0],
		[ 1, 0, 0, 0, 0, 1, 3, 3, 2, -18, 0, 0, 0, 0, 0],
		[ 1, 0, 0, 0, 0, 0, 1, 3, 2, 0, 0, 0, 0, 0, 0],
		[ 1, 0, 0, 0, 0, 0, 1, 3, 3, 2, 0, 0, 0, 0, 0],
		[ 0, 0, 0, 0, 0, 1, 1, 3, 3, 2, -18, 0, 0, 0, 0],
		[ 0, 0, 0, 0, 1, 1, 3, 3, 2, 0, 0, 0, 0, 0, 0],
		[ 1, 0, 0, 0, 1, 3, 3, 2, 0, 0, 0, 0, 0, 0, 0],
		[ 1, 0, 0, 0, 1, 3, 2, 0, 0, 0, 0, 0, 0, 0, 0],
		[ 1, 0, 0, 0, 0, 0, 0, 0, 0, 0, 0, 0, 0, 0, 0],
		[ 2, 0, 0, 0, 0, 0, 0, 0, 0, 0, 0, 0, 0, 0, 0],
		[ 2, 0, 0, 0, 0, 0, 0, 0, 0, 0, 0, 0, 0, 0, 0],
		[ 2, 0, 0, 0, 0, 0, 0, 0, 0, 0, 0, 0, 0, 0, 0],
		[ 1, 2, 0, 0, 0, 0, 0, 0, 0, 0, 0, 0, 0, 0, 0],
		[ 1, 1, 3, 2, 0, 0, 0, 0, 0, 0, 0, 0, 0, 0, 0],
		[ 3, 1, 1, 3, 2, 0, 0, 0, 0, 0, 0, 0, 0, 0, 0],
		[ 1, 2, 0, 0, 3, 3, 1, 2, 0, 0, 0, 0, 0, 0, 0],
		[ 3, 2, 0, 0, 0, 0, 0, 1, 3, 2, 0, 0, 0, 0, 0],
		[ 2, 0, 0, 0, 0, 0, 0, 0, 0, 3, 2, -18, 0, 0, 0],
		[ 2, 0, 0, 0, 0, 0, 0, 0, 0, 0, 0, 0, 0, 0, 0],
		[ 2, 0, 0, 0, 2, 0, 0, 0, 0, 0, 0, 0, 0, 0, 0],
		[ 2, 0, 0, 0, 3, 2, 0, 0, 0, 0, 0, 0, 0, 0, 0],
		[ 0, 0, 0, 0, 0, 3, 2, 0, 0, 0, 0, 0, 0, 0, 0],
		[ 0, 0, 0, 0, 0, 3, 3, 3, 3, 3, 2, 0, 0, 0, 0],
		[ 2, 0, 0, 0, 3, 1, 1, 2, 0, 0, 0, 0, 0, 0, 0],
		[ 1, 2, -18, 3, 2, 0, 0, 0, 0, 0, 0, 0, 0, 0, 0],
		[ 1, 1, 3, 2, -18, 0, 0, 0, 0, 0, 0, 0, 0, 0, 0],
		[ 1, 2, 0, 0, 0, 0, 0, 0, 0, 0, 0, 0, 0, 0, 0],
		[ 2, 0, 0, 0, 0, 0, 0, 0, 0, 0, 0, 0, 0, 0, 0],
		[ 2, 0, 0, 0, 0, 0, 0, 0, 0, 0, 0, 0, 0, 0, 0],
		[ 2, 0, 0, 0, 0, 0, 0, 0, 0, 0, 0, 0, 0, 0, 0],
		[ 2, 0, 0, 0, 0, 0, 0, 0, 0, 0, 0, 0, 0, 0, 0],
		[ 2, 0, 0, 0, 0, 0, 0, 0, 2, 0, 0, 0, 0, 0, 0],
		[ 2, 0, 0, 0, 0, 0, 0, 0, 3, 2, 0, 0, 0, 0, 0],
		[ 3, 2, 0, 0, 0, 0, 0, 0, 0, 3, 2, 0, 0, 0, 0],
		[ 3, 3, 2, 0, 0, 0, 0, 0, 0, 3, 3, 2, 0, 0, 0],
		[ 1, 3, 2, 0, 0, 0, 0, 0, 0, 0, 3, 2, 0, 0, 0],
		[ 1, 3, 3, 2, -18, 0, 0, 0, 0, 0, 3, 2, -18, 0, 0],
		[ 1, 1, 3, 3, 2, 0, 0, 0, 0, 0, 3, 2, 0, 0, 0],
		[ 1, 1, 1, 1, 3, 3, 2, 0, 3, 3, 3, 1, 0, 0, 0],
		[ 1, 1, 1, 1, 1, 3, 3, 3, 1, 1, 1, 1, 0, 0, 2],
		[ 1, 1, 1, 1, 1, 1, 1, 1, 1, 1, 1, 1, 0, 0, 2]
	],
	"buttomBorder": "false",
	"rightBorder": "false",
	"links": [
		{
			"target": {
				"name": "test-map2",
				"x": 5,
				"y": 14
			},
			"type": "down",
			"min": 21,
			"max": 25
		},
		{
			"target": {
				"name": "test-map2",
				"x": 16,
				"y": 14
			},
			"type": "down",
			"min": 39,
			"max": 43
		},
		{
			"target": {
				"name": "test-map",
				"x": 0,
				"y": 4
			},
			"type": "right",
			"min": 11,
			"max": 14
		}
	]
}